											   XXXXXXXXXXXXXXXXXXXXXXXXXXXXXXXXXXX     
											   XXXX                                    
											   XXXX                                    
											   X                                       
											   X                                       
							   XXXXXX          XXXXXXXX                                
														XXXXXX                         
													   XXX                             
													X XXXX       XXXXX       XXXXXXXXXX
XXXXXXXXX  XX  XX  X  XXXXXXX  XXX  XXX   XXX   X     XXXXXXXX   XXXXX       XXXXXXXXXX
XXXXXXXXX  XX  XX  X  XXXXXXX  XXXXXXXX   XXX         XXXXXXXX   XXXXX       XXXXXXXXXX
XXXXXXXXX  XX  XX  X  XXXXXXX  XXXXXXXX   XXX         XXXXXXXX   XXXXX       XXXXXXXXXX
